[buildbot.util]
MasterLock = buildbot.locks:MasterLock
ChangeFilter = buildbot.changes.filter:ChangeFilter
RETRY = buildbot.status.results:RETRY
DbConfig = buildbot.db.dbconfig:DbConfig
BuildFactory = buildbot.process.factory:BuildFactory
Authz = buildbot.www.authz:Authz
UserPasswordAuth = buildbot.www.auth:UserPasswordAuth
repo.DownloadsFromProperties = buildbot.steps.source.repo:RepoDownloadsFromProperties
RevlinkMatch = buildbot.revlinks:RevlinkMatch
FlattenList = buildbot.process.properties:FlattenList
enforceChosenSlave = buildbot.process.builder:enforceChosenSlave
Interpolate = buildbot.process.properties:Interpolate
AuthorizedKeysManhole = buildbot.manhole:AuthorizedKeysManhole
AnyEndpointMatcher = buildbot.www.authz.endpointmatchers:AnyEndpointMatcher
Results = buildbot.status.results:Results
CodebaseParameter = buildbot.schedulers.forcesched:CodebaseParameter
AnyPropertyParameter = buildbot.schedulers.forcesched:AnyPropertyParameter
HTPasswdAuth = buildbot.www.auth:HTPasswdAuth
IntParameter = buildbot.schedulers.forcesched:IntParameter
BasicBuildFactory = buildbot.process.factory:BasicBuildFactory
BooleanParameter = buildbot.schedulers.forcesched:BooleanParameter
ForceBuildEndpointMatcher = buildbot.www.authz.endpointmatchers:ForceBuildEndpointMatcher
StringParameter = buildbot.schedulers.forcesched:StringParameter
EqConnectionPool = buildbot.steps.mtrlogobserver:EqConnectionPool
BasicSVN = buildbot.process.factory:BasicSVN
svn.split_file_alwaystrunk = buildbot.changes.svnpoller:split_file_alwaystrunk
PasswordManhole = buildbot.manhole:PasswordManhole
WARNINGS = buildbot.status.results:WARNINGS
LdapUserInfo = buildbot.www.ldapuserinfos:LdapUserInfo
ShellArg = buildbot.steps.shellsequence:ShellArg
GitHubAuth = buildbot.www.oauth2:GitHubAuth
StopBuildEndpointMatcher = buildbot.www.authz.endpointmatchers:StopBuildEndpointMatcher
GNUAutoconf = buildbot.process.factory:GNUAutoconf
RemoteUserAuth = buildbot.www.auth:RemoteUserAuth
WithProperties = buildbot.process.properties:WithProperties
GerritChangeFilter = buildbot.changes.gerritchangesource:GerritChangeFilter
TextParameter = buildbot.schedulers.forcesched:TextParameter
SUCCESS = buildbot.status.results:SUCCESS
LogLineObserver = buildbot.process.logobserver:LogLineObserver
fnmatchStrMatcher = buildbot.www.authz:fnmatchStrMatcher
BuildslaveChoiceParameter = buildbot.schedulers.forcesched:BuildslaveChoiceParameter
EXCEPTION = buildbot.status.results:EXCEPTION
ParameterGroup = buildbot.schedulers.forcesched:ParameterGroup
ChoiceStringParameter = buildbot.schedulers.forcesched:ChoiceStringParameter
Trial = buildbot.process.factory:Trial
Connection = buildbot.buildslave.libvirt:Connection
CPAN = buildbot.process.factory:CPAN
QuickBuildFactory = buildbot.process.factory:QuickBuildFactory
TelnetManhole = buildbot.manhole:TelnetManhole
CANCELLED = buildbot.status.results:CANCELLED
NestedParameter = buildbot.schedulers.forcesched:NestedParameter
BuilderConfig = buildbot.config:BuilderConfig
Property = buildbot.process.properties:Property
repo.DownloadsFromChangeSource = buildbot.steps.source.repo:RepoDownloadsFromChangeSource
svn.split_file_projects_branches = buildbot.changes.svnpoller:split_file_projects_branches
SKIPPED = buildbot.status.results:SKIPPED
reStrMatcher = buildbot.www.authz:reStrMatcher
Distutils = buildbot.process.factory:Distutils
FixedParameter = buildbot.schedulers.forcesched:FixedParameter
InheritBuildParameter = buildbot.schedulers.forcesched:InheritBuildParameter
AvatarGravatar = buildbot.www.avatar:AvatarGravatar
UserNameParameter = buildbot.schedulers.forcesched:UserNameParameter
SlaveLock = buildbot.locks:SlaveLock
FAILURE = buildbot.status.results:FAILURE
svn.split_file_branches = buildbot.changes.svnpoller:split_file_branches
CommandlineUserManager = buildbot.process.properties:CommandlineUserManager
GoogleAuth = buildbot.www.oauth2:GoogleAuth
renderer = buildbot.process.properties:renderer

[buildbot.reporters]
MailNotifier = buildbot.reporters.mail:MailNotifier
GerritStatusPush = buildbot.reporters.gerrit:GerritStatusPush

[buildbot.schedulers]
Try_Userpass = buildbot.schedulers.trysched:Try_Userpass
Try_Jobdir = buildbot.schedulers.trysched:Try_Jobdir
AnyBranchScheduler = buildbot.schedulers.basic:AnyBranchScheduler
Dependent = buildbot.schedulers.dependent:Dependent
NightlyTriggerable = buildbot.schedulers.timed:NightlyTriggerable
SingleBranchScheduler = buildbot.schedulers.basic:SingleBranchScheduler
Nightly = buildbot.schedulers.timed:Nightly
Periodic = buildbot.schedulers.timed:Periodic
ForceScheduler = buildbot.schedulers.forcesched:ForceScheduler
Triggerable = buildbot.schedulers.triggerable:Triggerable

[buildbot.buildslave]
OpenStackLatentBuildSlave = buildbot.buildslave.openstack:OpenStackLatentBuildSlave
BuildSlave = buildbot.buildslave.base:BuildSlave
LibVirtSlave = buildbot.buildslave.libvirt:LibVirtSlave
EC2LatentBuildSlave = buildbot.buildslave.ec2:EC2LatentBuildSlave
DockerLatentBuildSlave = buildbot.buildslave.docker:DockerLatentBuildSlave

[buildbot.changes]
BitbucketPullrequestPoller = buildbot.changes.bitbucket:BitbucketPullrequestPoller
BonsaiPoller = buildbot.changes.bonsaipoller:BonsaiPoller
BzrLaunchpadEmailMaildirSource = buildbot.changes.mail:BzrLaunchpadEmailMaildirSource
HgPoller = buildbot.changes.hgpoller:HgPoller
PBChangeSource = buildbot.changes.pb:PBChangeSource
GitPoller = buildbot.changes.gitpoller:GitPoller
MaildirSource = buildbot.changes.mail:MaildirSource
GerritChangeSource = buildbot.changes.gerritchangesource:GerritChangeSource
SVNPoller = buildbot.changes.svnpoller:SVNPoller
SVNCommitEmailMaildirSource = buildbot.changes.mail:SVNCommitEmailMaildirSource
P4Source = buildbot.changes.p4poller:P4Source
CVSMaildirSource = buildbot.changes.mail:CVSMaildirSource

[buildbot.steps]
FileExists = buildbot.steps.slave:FileExists
Git = buildbot.steps.source.git:Git
VS2008 = buildbot.steps.vstudio:VS2008
FileDownload = buildbot.steps.transfer:FileDownload
VS2005 = buildbot.steps.vstudio:VS2005
StringDownload = buildbot.steps.transfer:StringDownload
PyLint = buildbot.steps.python:PyLint
UbuCowbuilder = buildbot.steps.package.deb.pbuilder:UbuCowbuilder
DebCowbuilder = buildbot.steps.package.deb.pbuilder:DebCowbuilder
MsBuild = buildbot.steps.vstudio:MsBuild
RpmBuild = buildbot.steps.package.rpm.rpmbuild:RpmBuild
FileUpload = buildbot.steps.transfer:FileUpload
ShellSequence = buildbot.steps.shellsequence:ShellSequence
VC7 = buildbot.steps.vstudio:VC7
Test = buildbot.steps.shell:Test
Cppcheck = buildbot.steps.cppcheck:Cppcheck
OPTIONS = buildbot.steps.http:OPTIONS
Mock = buildbot.steps.package.rpm.mock:Mock
RpmSpec = buildbot.steps.package.rpm.rpmspec:RpmSpec
HLint = buildbot.steps.python_twisted:HLint
MsBuild4 = buildbot.steps.vstudio:MsBuild4
VC10 = buildbot.steps.vstudio:VC10
VC11 = buildbot.steps.vstudio:VC11
Configure = buildbot.steps.shell:Configure
GET = buildbot.steps.http:GET
MasterShellCommand = buildbot.steps.master:MasterShellCommand
Bzr = buildbot.steps.source.bzr:Bzr
MaxQ = buildbot.steps.maxq:MaxQ
WarningCountingShellCommand = buildbot.steps.shell:WarningCountingShellCommand
CopyDirectory = buildbot.steps.slave:CopyDirectory
SubunitShellCommand = buildbot.steps.subunit:SubunitShellCommand
BuildStep = buildbot.process.buildstep:BuildStep
Repo = buildbot.steps.source.repo:Repo
SetPropertiesFromEnv = buildbot.steps.slave:SetPropertiesFromEnv
MsBuild12 = buildbot.steps.vstudio:MsBuild12
VC6 = buildbot.steps.vstudio:VC6
JSONStringDownload = buildbot.steps.transfer:JSONStringDownload
VC8 = buildbot.steps.vstudio:VC8
RemovePYCs = buildbot.steps.python_twisted:RemovePYCs
HTTPStep = buildbot.steps.http:HTTPStep
JSONPropertiesDownload = buildbot.steps.transfer:JSONPropertiesDownload
SVN = buildbot.steps.source.svn:SVN
VC12 = buildbot.steps.vstudio:VC12
HEAD = buildbot.steps.http:HEAD
Robocopy = buildbot.steps.mswin:Robocopy
Sphinx = buildbot.steps.python:Sphinx
MockBuildSRPM = buildbot.steps.package.rpm.mock:MockBuildSRPM
P4 = buildbot.steps.source.p4:P4
MTR = buildbot.steps.mtrlogobserver:MTR
Mercurial = buildbot.steps.source.mercurial:Mercurial
TreeSize = buildbot.steps.shell:TreeSize
VS2012 = buildbot.steps.vstudio:VS2012
VS2013 = buildbot.steps.vstudio:VS2013
MultipleFileUpload = buildbot.steps.transfer:MultipleFileUpload
CVS = buildbot.steps.source.cvs:CVS
Compile = buildbot.steps.shell:Compile
SetProperty = buildbot.steps.master:SetProperty
VS2003 = buildbot.steps.vstudio:VS2003
LogRenderable = buildbot.steps.master:LogRenderable
UbuPbuilder = buildbot.steps.package.deb.pbuilder:UbuPbuilder
PerlModuleTest = buildbot.steps.shell:PerlModuleTest
RemoveDirectory = buildbot.steps.slave:RemoveDirectory
VC9 = buildbot.steps.vstudio:VC9
MockRebuild = buildbot.steps.package.rpm.mock:MockRebuild
POST = buildbot.steps.http:POST
PyFlakes = buildbot.steps.python:PyFlakes
BuildEPYDoc = buildbot.steps.python:BuildEPYDoc
PUT = buildbot.steps.http:PUT
Trial = buildbot.steps.python_twisted:Trial
DebPbuilder = buildbot.steps.package.deb.pbuilder:DebPbuilder
SetPropertyFromCommand = buildbot.steps.shell:SetPropertyFromCommand
ShellCommand = buildbot.steps.shell:ShellCommand
DirectoryUpload = buildbot.steps.transfer:DirectoryUpload
VS2010 = buildbot.steps.vstudio:VS2010
Trigger = buildbot.steps.trigger:Trigger
Darcs = buildbot.steps.source.darcs:Darcs
VCExpress9 = buildbot.steps.vstudio:VCExpress9
Monotone = buildbot.steps.source.mtn:Monotone
DebLintian = buildbot.steps.package.deb.lintian:DebLintian
MakeDirectory = buildbot.steps.slave:MakeDirectory
DELETE = buildbot.steps.http:DELETE

